1 4 4 4 4 4 4 4 4 4
1 0 0 0 0 0 0 0 0 4
1 0 0 0 0 0 0 0 0 4
1 0 0 0 0 0 0 0 0 4
1 0 0 0 0 0 0 0 0 4
1 0 0 0 0 0 0 0 0 4
2 3 3 3 3 3 3 3 3 3 